1111111111111
10C10000000C1
1010011111001
1P0011E0000K1
1111111111111
